111111
1P0011
110111
10C0E1
111111