111111
1P0011
110111
100EC1
111111