111111
1P0011
111111
10C0E1
111111