1111111111111111111
1P000001110C0000001
1100000C111000000C1
1000000000000011111
1000000001000010001
1000000000000000E01
1111111111111111111