1111111111111111111
1P000001110C0001001
1100000C111000000C1
1000000000000011111
1000000001000010101
1000000000000000EC1
1111111111111111111